1111111111111111
1000000000001C01
100000000ECP1001
1000000000001001
1111111111111111
