1111111111111111
1000000000000101
10P0000000C01E01
1000000000001001
1111111111110111
