111111111111111
1P0000000000001
1000000C0000001
100000000000001
1000000000000E1
111111111111111