111111111111111111111111111
100000000000000000000000001
100000111111100111111111101
100000100000001001000000001
100000100000000000E00100001
10000010000000000C000101001
10011110000010C0000000C0001
100000111111111111000111111
100111100000000000001000001
100011111100111111000011111
100000000000110111101000P01
111111111111111111111111111
